BLUE	B L UW
BRIGHT	B R AY T
DARK	D AA R K
FRIEND	F R EH N D
GREEN	G R IY N
LIGHT	L AY T
MAKE	M EY K
OFF	AO F
ON	AA N
ON(2)	AO N
ORANGE	AO R AH N JH
ORANGE(2)	AO R IH N JH
PINK	P IH NG K
PURPLE	P ER P AH L
RED	R EH D
THE	DH AH
THE(2)	DH IY
TURN	T ER N
WHITE	W AY T
WHITE(2)	HH W AY T
YELLOW	Y EH L OW
